111111111111111111
100100000000001001
1P*****00000010*01
10**00*0***00**001
10*00******0*00*01
10C00C*0*****00001
100001000C0*0C0001
10001101000M0001E1
111111111111111111